1111111111111111
10001100011100E1
1000100000100011
10000000000000C1
1000000000000001
1111111111001111
1111111111000111
11111111100000C1
1000000000000001
1P00001110000111
1111111111111111