11111111111111111111111111111111111
11111111111111000111111111111111111
11111111111110010011111111111111111
1E00000M0000000C000000M000000110011
10100101001000001011010000000000011
1010010010101M100010011100011101001
1P0000000C00C0000010000000000000C01
1000000001000000000000C000000000M11
11111111111111111111111111111111111